0 0 0 1 1 1 80031 1 1 1
0 0 210 1 1 1 1 311 1 1
2 0 0 1 1 1 1 1 1 1
0 0 0 500021 1 1 1 1 1 1
0 0 0 1 1 1 1 1 1 1
1 1 1 1 1 1 1 350021 1 1
1 1 1 400021 1 111 1 1 1 1
1 1 1 1 1 1 1 1 1 1
1 1 1 1 1 1 1 1 40031 1
1 1 1 70031 1 1 411 1 1 1